
conflict 冲突

branches 分支

executable 可执行文件

cluster	集群

in effect	实际上

mined	开采的

chain	链子;链条;连锁;连续;拘束;连锁店或旅馆系列的事物

generate	形成;造成;生成

variables	变量

sensitive	敏感的

recommend 	推荐

otherwise	否则

generate	生成

components	组件

brief		短暂的;简洁的;简明的

insertion	插入 —— 记忆技巧：insert 插入 + ion 表名词 → 插入

deletion	删除 —— 

binary		二进制的;二元的;双重的，由两个东西组成的;二态的

uncaught	未捕获

property	属性

pipe		管子;烟斗;管乐器;（管风琴的）音管

pipeline	管道;输油管道;渠道

force		强迫;强行;促使;推动

production	产量;产品;生产;制作

costs		价钱为;花费( cost的第三人称单数 );估计成本;付出（代价）;估价

supply		供应量;供给;补充;弥补（缺陷、损失等）;向…提供（物资等）

optional	可选择的;选修的

format		格式

syntax		句法;句法规则;语构

elegant		优美的;文雅的;漂亮雅致的;陈设讲究的;精美的;简练的;简洁的;简明的

reference	查阅;参考;


















